1111111111111
1001P000E0PC1
1000000000001
1111111111111